//MAP CONVERTED BY dmm2tgm.py THIS HEADER COMMENT PREVENTS RECONVERSION, DO NOT REMOVE
"a" = (
/turf/default,
/area)
"Y" = (
/turf/border,
/area)

(1,1,1) = {"
a
Y
a
Y
a
Y
a
Y
a
Y
a
Y
a
Y
a
Y
a
"}
(2,1,1) = {"
Y
a
Y
a
Y
a
Y
a
Y
a
Y
a
Y
a
Y
a
Y
"}
(3,1,1) = {"
a
Y
a
Y
a
Y
a
Y
a
Y
a
Y
a
Y
a
Y
a
"}
(4,1,1) = {"
Y
a
Y
a
Y
a
Y
a
Y
a
Y
a
Y
a
Y
a
Y
"}
(5,1,1) = {"
a
Y
a
Y
a
Y
a
Y
a
Y
a
Y
a
Y
a
Y
a
"}
(6,1,1) = {"
Y
a
Y
a
Y
a
Y
a
Y
a
Y
a
Y
a
Y
a
Y
"}
(7,1,1) = {"
a
Y
a
Y
a
Y
a
Y
a
Y
a
Y
a
Y
a
Y
a
"}
(8,1,1) = {"
Y
a
Y
a
Y
a
Y
a
Y
a
Y
a
Y
a
Y
a
Y
"}
(9,1,1) = {"
a
Y
a
Y
a
Y
a
Y
a
Y
a
Y
a
Y
a
Y
a
"}
(10,1,1) = {"
Y
a
Y
a
Y
a
Y
a
Y
a
Y
a
Y
a
Y
a
Y
"}
(11,1,1) = {"
a
Y
a
Y
a
Y
a
Y
a
Y
a
Y
a
Y
a
Y
a
"}
(12,1,1) = {"
Y
a
Y
a
Y
a
Y
a
Y
a
Y
a
Y
a
Y
a
Y
"}
(13,1,1) = {"
a
Y
a
Y
a
Y
a
Y
a
Y
a
Y
a
Y
a
Y
a
"}
(14,1,1) = {"
Y
a
Y
a
Y
a
Y
a
Y
a
Y
a
Y
a
Y
a
Y
"}
(15,1,1) = {"
a
Y
a
Y
a
Y
a
Y
a
Y
a
Y
a
Y
a
Y
a
"}
(16,1,1) = {"
Y
a
Y
a
Y
a
Y
a
Y
a
Y
a
Y
a
Y
a
Y
"}
(17,1,1) = {"
a
Y
a
Y
a
Y
a
Y
a
Y
a
Y
a
Y
a
Y
a
"}
(18,1,1) = {"
Y
a
Y
a
Y
a
Y
a
Y
a
Y
a
Y
a
Y
a
Y
"}
(19,1,1) = {"
a
Y
a
Y
a
Y
a
Y
a
Y
a
Y
a
Y
a
Y
a
"}
(20,1,1) = {"
Y
a
Y
a
Y
a
Y
a
Y
a
Y
a
Y
a
Y
a
Y
"}
