//MAP CONVERTED BY dmm2tgm.py THIS HEADER COMMENT PREVENTS RECONVERSION, DO NOT REMOVE
"a" = (
/turf/default,
/area)
"z" = (
/obj/cardholder/opponent,
/turf/default,
/area)
"B" = (
/obj/endturn_button,
/turf/default,
/area)
"J" = (
/turf/border,
/area)
"M" = (
/obj/cardholder,
/turf/default,
/area)

(1,1,1) = {"
a
a
a
a
a
a
a
a
a
a
a
a
a
a
a
a
a
"}
(2,1,1) = {"
a
a
a
a
a
a
a
a
a
a
a
a
a
a
a
a
a
"}
(3,1,1) = {"
a
a
a
a
a
a
a
a
a
a
a
a
a
a
a
a
a
"}
(4,1,1) = {"
a
a
a
J
J
J
J
J
J
J
J
J
J
J
a
a
a
"}
(5,1,1) = {"
a
a
a
J
a
a
a
a
a
a
a
a
a
J
a
a
a
"}
(6,1,1) = {"
a
a
a
J
a
a
a
z
a
a
a
M
a
J
a
a
a
"}
(7,1,1) = {"
a
a
a
J
a
a
a
a
a
a
a
a
a
J
a
a
a
"}
(8,1,1) = {"
a
a
a
J
a
a
a
z
a
a
a
M
a
J
a
a
a
"}
(9,1,1) = {"
a
a
a
J
a
a
a
a
a
a
a
a
a
J
a
a
a
"}
(10,1,1) = {"
a
a
a
J
a
a
a
z
a
a
a
M
a
J
a
a
a
"}
(11,1,1) = {"
a
a
a
J
a
a
a
a
a
a
a
a
a
J
a
a
a
"}
(12,1,1) = {"
a
a
a
J
a
a
a
z
a
a
a
M
a
J
a
a
a
"}
(13,1,1) = {"
a
a
a
J
a
a
a
a
a
a
a
a
a
J
a
a
a
"}
(14,1,1) = {"
a
a
a
J
a
a
a
z
a
a
a
M
a
J
a
a
a
"}
(15,1,1) = {"
a
a
a
J
a
a
a
a
a
a
a
a
a
J
a
a
a
"}
(16,1,1) = {"
a
a
a
J
a
a
a
a
B
a
a
a
a
J
a
a
a
"}
(17,1,1) = {"
a
a
a
J
J
J
J
J
J
J
J
J
J
J
a
a
a
"}
(18,1,1) = {"
a
a
a
a
a
a
a
a
a
a
a
a
a
a
a
a
a
"}
(19,1,1) = {"
a
a
a
a
a
a
a
a
a
a
a
a
a
a
a
a
a
"}
(20,1,1) = {"
a
a
a
a
a
a
a
a
a
a
a
a
a
a
a
a
a
"}
